12:12,
85,34,18,18,18,18,18,18,18,18,18,85,
53,34,18,4,0,0,6,0,0,4,18,6,
6,34,18,0,34,34,34,34,34,6,18,4,
4,34,18,0,34,6,11,6,34,6,18,4,
6,34,18,6,34,0,6,0,34,0,18,4,
6,34,18,0,34,34,4,34,34,0,18,4,
6,34,18,0,18,4,0,6,0,0,18,0,
0,34,18,4,18,18,18,18,18,18,18,0,
0,4,34,0,0,0,0,0,0,0,0,0,
34,0,34,0,0,0,0,0,0,0,0,0,
34,0,0,0,0,0,0,0,0,0,0,0,
89,0,0,34,0,0,0,0,0,0,0,0,
