12:12,
89,0,18,18,18,18,18,18,18,18,18,18,
18,0,4,0,6,18,8,0,0,0,4,53,
18,34,34,34,4,34,18,18,18,0,4,53,
18,0,0,0,0,34,0,0,18,0,4,18,
34,4,34,18,18,4,0,0,18,18,0,0,
34,0,0,0,0,0,0,0,0,18,6,0,
34,0,4,4,4,0,0,0,18,18,0,0,
34,0,4,85,53,4,85,18,0,0,18,0,
18,0,34,18,34,34,0,0,0,0,18,0,
34,0,34,18,0,0,0,0,0,0,18,4,
34,0,34,18,0,34,34,34,34,34,18,6,
9,0,34,18,0,0,0,0,0,0,0,4,
