12:12,
89,0,0,0,0,4,0,0,4,0,0,0,
34,34,34,0,18,4,34,34,34,34,0,0,
0,0,0,0,34,4,18,0,0,18,0,0,
0,34,0,0,18,4,18,0,0,18,0,0,
34,0,34,0,18,8,18,0,0,18,0,0,
0,0,34,0,18,18,18,0,0,18,0,0,
0,0,0,0,0,0,0,0,0,18,0,0,
0,34,4,34,0,0,0,0,0,18,0,0,
0,34,34,34,0,0,0,0,0,18,0,0,
0,0,0,0,0,0,0,0,0,18,0,0,
18,18,18,18,18,18,18,18,18,18,4,4,
10,0,0,0,0,0,0,0,0,0,0,0,
