12:12,
9,0,0,4,34,34,34,0,0,0,0,0,
34,34,0,18,34,34,34,0,0,0,0,0,
0,18,0,18,34,34,34,0,0,0,0,0,
0,18,0,0,4,0,0,0,4,18,18,4,
0,18,0,0,0,0,0,0,18,0,0,0,
34,0,0,18,0,0,0,0,18,4,18,18,
4,4,0,0,0,0,0,0,34,0,0,0,
0,34,0,34,34,34,4,4,4,18,18,4,
0,34,34,0,4,4,34,4,18,0,0,0,
4,8,34,0,34,0,4,0,18,0,18,4,
34,34,34,0,34,34,34,34,34,0,18,18,
89,0,0,4,0,0,0,0,0,0,0,0,