12:12,
0,0,0,0,0,0,0,0,0,0,0,0,
18,18,18,18,18,4,34,34,34,34,34,34,
4,0,0,0,0,0,18,0,0,4,34,8,
0,18,18,18,18,18,18,0,34,34,4,4,
0,18,4,18,0,0,0,0,0,34,4,4,
0,34,4,34,0,0,0,0,0,0,0,0,
0,0,0,0,0,0,0,0,0,0,0,0,
0,0,0,0,0,0,34,34,34,34,34,4,
0,0,0,0,0,34,0,0,0,0,0,0,
34,34,34,34,34,0,0,0,0,0,0,0,
34,0,4,0,18,34,34,4,34,34,34,34,
9,0,34,0,4,0,0,0,0,0,0,0,